5 10
|--------|
|...|..-.|
|..-|.ᗤ..|
|......-.|
|--------|