5 10
|--------|
|.#.|..-.|
|..-|.C*.|
|.#....-.|
|--------|